8WWWWWWWWWW9W
WWWWWWWWWDWWW
RRRRRRRRRRRR.
...........U.
ARRR.RRRRR.U.
...1R2...3RU.
BRRR.RR.RR...
......U.U....
......4R5....
CRRRRRU.URRU.
.OOOOOOOORRU.